R  1080 720
NO ./textures/brick.xpm
SO ./textures/blue.xpm
WE ./textures/wood.xpm
EA ./textures/grey.xpm

S ./textures/chest.xpm
F 224,172,105
C 205,249,255

1 1 1 1 1 1 1 1 1 1 1 1 1 1
1 0 0 0 0 0 0 0 0 0 1 1 0 1
1 0 1 1 0 0 0 0 0 1 1 1 0 1
1 0 1 2 0 0 0 0 0 0 0 0 0 1
1 0 1 1 0 0 0 0 0 1 1 1 0 1
1 0 0 0 0 0 0 0 0 0 1 1 0 1
1 1 1 1 0 1 1 1 1 1 1 1 1 1
1 1 1 1 0 1 1 1 1 1 1 1 1 1
1 1 0 0 0 0 0 0 1 1 0 1 0 1
1 0 0 0 2 0 0 0 0 0 0 0 0 1
1 0 0 0 0 0 N 0 0 0 0 0 0 1
1 1 0 0 0 0 0 0 1 1 0 1 0 1
1 1 1 1 0 1 1 1 1 1 1 1 0 1
1 1 1 1 1 1 1 1 1 1 1 1 1 1
