R  1280 1024
NO ./textures/north.xpm
SO ./textures/south.xpm
WE ./textures/west.xpm
EA ./textures/east.xpm

S ./textures/sprite.xpm
F 105,105,105
C 200,235,235

        1111111111111111111111111
        1000000000110000000000001
        1011000001110000020000001
        100100000000E020000000001
111111111011000001110000000000001
100000000011000001110111111111111
11110111111111011100000010001
11110111111111011101010010001
11000000110101011100000010001
10002000000000001100000010001
10000000000000001101010010001
1100000111010101111101111000111
11110111 1112101 101111010001
11111111 1111111 111111111111
