R  1080 720
NO ./textures/textures1/north.xpm
SO ./textures/textures1/south.xpm
WE ./textures/textures1/west.xpm
EA ./textures/textures1/east.xpm

S ./textures/textures1/sprite.xpm
F 224,172,105
C 205,249,255

        1111111111111111111111111
        1000000000110000000000001
        1011000001110002020200001
        100100E000000000000000001
111111111011000001110000000000001
100000000011000001110111111111111
11110111111111011100000010001
11110111111111011101010010001
11000000110101011100000010001
10002000000000001100000010001
10000000000000001101010010001
1100000111010101111101111000111
11110111 1110101 101111010001
11111111 1111111 111111111111